1	1	1	1	0	1	5	10	1	1	1	1	1	0	1	1	1	0	1	1	0	1
1	1	1	1	0	4	1	1	1	3	0	0	0	0	9	9	9	0	8	4	0	1
1	1	1	1	0	7	1	1	1	6	0	1	1	1	8	7	8	0	6	3	0	1
1	1	1	1	0	1	1	9	8	1	0	1	1	1	1	0	1	0	1	1	0	1
1	0	0	0	0	0	0	0	0	0	0	7	9	1	1	0	1	0	8	10	0	1
1	0	1	9	6	3	1	1	1	0	0	7	7	1	1	0	1	0	9	8	0	1
1	0	1	1	1	1	1	1	7	0	0	0	0	0	0	0	0	0	0	0	0	1
1	0	1	1	1	1	1	1	8	0	0	1	3	5	4	5	3	0	1	3	0	1
1	0	1	9	4	1	1	1	4	0	0	1	1	1	1	1	1	0	4	1	0	1
1	0	1	4	0	0	0	0	0	0	0	0	0	0	0	0	0	2	1	5	0	1
1	0	1	1	0	1	1	1	1	0	0	1	3	3	3	3	1	0	6	1	0	1
1	0	1	9	0	0	0	0	0	0	0	0	0	0	0	0	0	0	1	7	0	1
1	0	1	7	0	0	1	1	1	0	0	0	0	0	0	0	0	0	8	1	0	1
1	0	1	10	0	4	7	1	1	0	0	8	1	0	1	9	5	0	1	9	0	0
1	0	1	1	0	3	1	1	5	0	0	1	4	0	1	1	7	0	9	1	0	1
1	0	1	1	0	1	1	1	5	0	0	4	1	0	6	1	1	0	1	8	0	1
1	0	1	1	0	11	10	1	4	0	0	1	4	0	9	1	1	0	7	1	0	1
1	0	1	1	0	10	8	1	1	0	0	8	1	0	3	1	1	0	1	6	0	1
1	0	0	0	0	0	0	0	0	0	0	0	0	0	1	1	1	0	5	1	0	1
1	1	1	1	0	0	0	0	0	0	0	0	0	0	1	10	10	0	1	4	0	1
1	1	1	1	0	1	1	1	8	0	0	1	1	0	1	15	15	0	3	1	0	1
1	1	0	0	0	0	0	1	10	0	0	1	1	0	1	10	10	0	0	0	0	1
1	1	0	1	10	1	0	1	9	0	0	1	1	0	1	1	1	0	1	1	1	1
1	1	0	10	5	3	0	1	1	0	0	1	1	0	1	1	1	0	1	1	1	1
1	1	0	0	0	0	0	0	0	0	0	0	0	0	0	0	0	0	0	0	1	1
1	1	0	1	1	1	0	1	1	1	1	1	1	0	10	1	10	0	1	0	1	1
1	1	0	1	1	1	0	1	8	1	1	1	1	0	1	1	9	0	1	0	1	1
0	0	0	1	1	1	0	10	6	0	0	0	0	0	1	1	7	0	1	0	1	1
1	1	1	1	1	1	0	1	1	1	1	1	1	1	1	1	9	0	1	0	0	0
1	1	1	1	1	1	0	0	0	0	0	0	0	1	1	1	10	0	1	1	1	1
1	1	1	1	1	1	1	1	1	1	1	1	1	1	1	1	1	0	1	1	1	1
1	1	1	1	0	1	5	10	1	1	1	1	1	0	1	1	1	0	1	1	0	1
1	1	1	1	0	4	1	1	1	3	0	0	0	0	9	9	9	0	8	4	0	1
1	1	1	1	0	7	1	1	1	6	0	1	1	1	8	7	8	0	6	3	0	1
1	1	1	1	0	1	1	9	8	1	0	1	1	1	1	0	1	0	1	1	0	1
1	0	0	0	0	0	0	0	0	0	0	7	9	1	1	0	1	0	8	10	0	1
1	0	1	9	6	3	1	1	1	0	0	7	7	1	1	0	1	0	9	8	0	1
1	0	1	1	1	1	1	1	7	0	0	0	0	0	0	0	0	0	0	0	0	1
1	0	1	1	1	1	1	1	8	0	0	1	3	5	4	5	3	0	1	3	0	1
1	0	1	9	4	1	1	1	4	0	0	1	1	1	1	1	1	0	4	1	0	1
1	0	1	4	0	0	0	0	0	0	0	0	0	0	0	0	0	0	1	5	0	1
1	0	1	1	0	1	1	1	1	0	0	1	3	3	3	3	1	0	6	1	0	1
1	0	1	9	0	0	0	0	0	0	0	0	0	0	0	0	0	0	1	7	0	1
1	0	1	7	0	0	1	1	1	0	0	0	0	0	0	0	0	0	8	1	0	1
1	0	1	10	0	4	7	1	1	0	0	8	1	0	1	9	5	0	1	9	0	0
1	0	1	1	0	3	1	1	5	0	0	1	4	0	1	1	7	0	9	1	0	1
1	0	1	1	0	1	1	1	5	0	0	4	1	0	6	1	1	0	1	8	0	1
1	0	1	1	0	11	10	1	4	0	0	1	4	0	9	1	1	0	7	1	0	1
1	0	1	1	0	10	8	1	1	0	0	8	1	0	3	1	1	0	1	6	0	1
1	0	0	0	0	0	0	0	0	0	0	0	0	0	1	1	1	0	5	1	0	1
1	1	1	1	0	0	0	0	0	0	0	0	0	0	1	10	10	0	1	4	0	1
1	1	1	1	0	1	1	1	8	0	0	1	1	0	1	15	15	0	3	1	0	1
1	1	0	0	0	0	0	1	10	0	0	1	1	0	1	10	10	0	0	0	0	1
1	1	0	1	10	1	0	1	9	0	0	1	1	0	1	1	1	0	1	1	1	1
1	1	0	10	5	3	0	1	1	0	0	1	1	0	1	1	1	0	1	1	1	1
1	1	0	0	0	0	0	0	0	0	0	0	0	0	0	0	0	0	0	0	1	1
1	1	0	1	1	1	0	1	1	1	1	1	1	0	10	1	10	0	1	0	1	1
1	1	0	1	1	1	0	1	8	1	1	1	1	0	1	1	9	0	1	0	1	1
0	0	0	1	1	1	0	10	6	0	0	0	0	0	1	1	7	0	1	0	1	1
1	1	1	1	1	1	0	1	1	1	1	1	1	1	1	1	9	0	1	0	0	0
1	1	1	1	1	1	0	0	0	0	0	0	0	1	1	1	10	0	1	1	1	1
1	1	1	1	1	1	1	1	1	1	1	1	1	1	1	1	1	0	1	1	1	1
1	1	1	1	0	1	5	10	1	1	1	1	1	0	1	1	1	0	1	1	0	1
1	1	1	1	0	4	1	1	1	3	0	0	0	0	9	9	9	0	8	4	0	1
1	1	1	1	0	7	1	1	1	6	0	1	1	1	8	7	8	0	6	3	0	1
1	1	1	1	0	1	1	9	8	1	0	1	1	1	1	0	1	0	1	1	0	1
1	0	0	0	0	0	0	0	0	0	0	7	9	1	1	0	1	0	8	10	0	1
1	0	1	9	6	3	1	1	1	0	0	7	7	1	1	0	1	0	9	8	0	1
1	0	1	1	1	1	1	1	7	0	0	0	0	0	0	0	0	0	0	0	0	1
1	0	1	1	1	1	1	1	8	0	0	1	3	5	4	5	3	0	1	3	0	1
1	0	1	9	4	1	1	1	4	0	0	1	1	1	1	1	1	0	4	1	0	1
1	0	1	4	0	0	0	0	0	0	0	0	0	0	0	0	0	0	1	5	0	1
1	0	1	1	0	1	1	1	1	0	0	1	3	3	3	3	1	0	6	1	0	1
1	0	1	9	0	0	0	0	0	0	0	0	0	0	0	0	0	0	1	7	0	1
1	0	1	7	0	0	1	1	1	0	0	0	0	0	0	0	0	0	8	1	0	1
1	0	1	10	0	4	7	1	1	0	0	8	1	0	1	9	5	0	1	9	0	0
1	0	1	1	0	3	1	1	5	0	0	1	4	0	1	1	7	0	9	1	0	1
1	0	1	1	0	1	1	1	5	0	0	4	1	0	6	1	1	0	1	8	0	1
1	0	1	1	0	11	10	1	4	0	0	1	4	0	9	1	1	0	7	1	0	1
1	0	1	1	0	10	8	1	1	0	0	8	1	0	3	1	1	0	1	6	0	1
1	0	0	0	0	0	0	0	0	0	0	0	0	0	1	1	1	0	5	1	0	1
1	1	1	1	0	0	0	0	0	0	0	0	0	0	1	10	10	0	1	4	0	1
1	1	1	1	0	1	1	1	8	0	0	1	1	0	1	15	15	0	3	1	0	1
1	1	0	0	0	0	0	1	10	0	0	1	1	0	1	10	10	0	0	0	0	1
1	1	0	1	10	1	0	1	9	0	0	1	1	0	1	1	1	0	1	1	1	1
1	1	0	10	5	3	0	1	1	0	0	1	1	0	1	1	1	0	1	1	1	1
1	1	0	0	0	0	0	0	0	0	0	0	0	0	0	0	0	0	0	0	1	1
1	1	0	1	1	1	0	1	1	1	1	1	1	0	10	1	10	0	1	0	1	1
1	1	0	1	1	1	0	1	8	1	1	1	1	0	1	1	9	0	1	0	1	1
0	0	0	1	1	1	0	10	6	0	0	0	0	0	1	1	7	0	1	0	1	1
1	1	1	1	1	1	0	1	1	1	1	1	1	1	1	1	9	0	1	0	0	0
1	1	1	1	1	1	0	0	0	0	0	0	0	1	1	1	10	0	1	1	1	1
1	1	1	1	1	1	1	1	1	1	1	1	1	1	1	1	1	0	1	1	1	1
1	1	1	1	0	1	5	10	1	1	1	1	1	0	1	1	1	0	1	1	0	1
1	1	1	1	0	4	1	1	1	3	0	0	0	0	9	9	9	0	8	4	0	1
1	1	1	1	0	7	1	1	1	6	0	1	1	1	8	7	8	0	6	3	0	1
1	1	1	1	0	1	1	9	8	1	0	1	1	1	1	0	1	0	1	1	0	1
1	0	0	0	0	0	0	0	0	0	0	7	9	1	1	0	1	0	8	10	0	1
1	0	1	9	6	3	1	1	1	0	0	7	7	1	1	0	1	0	9	8	0	1
1	0	1	1	1	1	1	1	7	0	0	0	0	0	0	0	0	0	0	0	0	1
1	0	1	1	1	1	1	1	8	0	0	1	3	5	4	5	3	0	1	3	0	1
1	0	1	9	4	1	1	1	4	0	0	1	1	1	1	1	1	0	4	1	0	1
1	0	1	4	0	0	0	0	0	0	0	0	0	0	0	0	0	0	1	5	0	1
1	0	1	1	0	1	1	1	1	0	0	1	3	3	3	3	1	0	6	1	0	1
1	0	1	9	0	0	0	0	0	0	0	0	0	0	0	0	0	0	1	7	0	1
1	0	1	7	0	0	1	1	1	0	0	0	0	0	0	0	0	0	8	1	0	1
1	0	1	10	0	4	7	1	1	0	0	8	1	0	1	9	5	0	1	9	0	0
1	0	1	1	0	3	1	1	5	0	0	1	4	0	1	1	7	0	9	1	0	1
1	0	1	1	0	1	1	1	5	0	0	4	1	0	6	1	1	0	1	8	0	1
1	0	1	1	0	11	10	1	4	0	0	1	4	0	9	1	1	0	7	1	0	1
1	0	1	1	0	10	8	1	1	0	0	8	1	0	3	1	1	0	1	6	0	1
1	0	0	0	0	0	0	0	0	0	0	0	0	0	1	1	1	0	5	1	0	1
1	1	1	1	0	0	0	0	0	0	0	0	0	0	1	10	10	0	1	4	0	1
1	1	1	1	0	1	1	1	8	0	0	1	1	0	1	15	15	0	3	1	0	1
1	1	0	0	0	0	0	1	10	0	0	1	1	0	1	10	10	0	0	0	0	1
1	1	0	1	10	1	0	1	9	0	0	1	1	0	1	1	1	0	1	1	1	1
1	1	0	10	5	3	0	1	1	0	0	1	1	0	1	1	1	0	1	1	1	1
1	1	0	0	0	0	0	0	0	0	0	0	0	0	0	0	0	0	0	0	1	1
1	1	0	1	1	1	0	1	1	1	1	1	1	0	10	1	10	0	1	0	1	1
1	1	0	1	1	1	0	1	8	1	1	1	1	0	1	1	9	0	1	0	1	1
0	0	0	1	1	1	0	10	6	0	0	0	0	0	1	1	7	0	1	0	1	1
1	1	1	1	1	1	0	1	1	1	1	1	1	1	1	1	9	0	1	0	0	0
1	1	1	1	1	1	0	0	0	0	0	0	0	1	1	1	10	0	1	1	1	1
1	1	1	1	1	1	1	1	1	1	1	1	1	1	1	1	1	0	1	1	1	1